NO ./textures/matrix.png
SO ./textures/matrix.png
WE ./textures/matrix.png
EA ./textures/matrix.png

F 220,100,0
C 225,30,0

1111111111111111111111
1000000000000000000001
1000000000000000000001
1000000000000000000001
1000000000000000000001
1000000000000000000E01
11111111111111111111100
11111111111111111111100
1000000000000000000001
1000000000000000000001
1000000000000000000001
1000000000000000000001
1000000000000000000001
0111111111111111111110
